// === Персонажи (JP -> RU) ===

グローザ -> Гроза | пол: женский
ネメシス -> Немезида | пол: женский
トロロ -> Тололо | пол: женский
クルカイ -> Клукай | пол: женский
レナ -> Ленна | пол: женский
スオミ -> Суоми | пол: женский
ダイヤ― -> Дайян | пол: женский
ジャンユー -> Цзяньюй | пол: женский
センタウレイシー -> Центауресси | пол: женский
ヴェプレー -> Веплей | пол: женский
ペリティア -> Перития | пол: женский
サブリナ -> Сабрина | пол: женский
チータ -> Чита | пол: женский
ロッタ -> Лотта | пол: женский
ナガン -> Наган | пол: женский
パパシャ -> Папаша | пол: женский
モシン・ナガン -> Мосин-Наган | пол: женский
スプリングフィールド -> Спрингфилд | пол: женский
ヴェクター -> Вектор | пол: женский
ウルリッド -> Улльрид | пол: женский
ディエリ -> Дьер | пол: мужской
クセニア -> Ксения | пол: женский
ドゥシェーヴナヤ -> Душевная | пол: женский
コルフ -> Колфне | пол: женский
キャロリック -> Кролик | пол: женский
マキアート -> Макиатто | пол: женский
シャークリー -> Шаркри | пол: женский
フェータス -> Фаэтуса | пол: женский
チョンジュ -> Цюнцзю | пол: женский
ジャオフイ -> Чжаохуэй | пол: женский
リンド -> Линд | пол: женский
ルイス -> Льюис | пол: женский
レイニー -> Лейни | пол: женский
ヘレン -> Хелен | пол: женский
フローレンス -> Флоренс | пол: женский
フェー -> Фэй | пол: женский
フェージャ -> Федя | пол: мужской
アルヴァ -> Альва | пол: женский
スエ -> Сьер | пол: женский
イゴレクサ -> Игорекса | пол: мужской
ロベラ -> Робелла | пол: женский
リッタラ -> Литтара | пол: женский
メシティ -> Мечты | пол: женский
ニケータ -> Никкета | пол: женский
ペリ -> Пери | пол: женский
チウホウ -> Цюхуа | пол: женский
ヴォイマスティナ -> Воймастина | пол: женский
ユーヒ -> Юхи | пол: женский
イサ -> Иса | пол: женский
イスラ -> Исла | пол: женский
ジムママン -> Зиммерман | пол: мужской
メロニ -> Мелони | пол: женский
ブルースフィア -> Блюсфера | пол: женский
ロニー -> Лонни | пол: мужской
レンティーナ -> Лентина | пол: женский
カリーナ -> Калина | пол: женский
G11 -> Gr G11 | пол: женский
SOPMOD -> Соппо | пол: женский
ココン -> Кокон | пол: женский
アーキテクト -> Архитектор | пол: женский
エージェント -> Агент | пол: женский
モリドー -> Морридоу | пол: женский
ショー -> Командир Шоу | пол: мужской
イェーツ -> Капитан Йейтс | пол: мужской
ソレン -> Сорен | пол: мужской
マーサ -> Марта | пол: женский

// === Фракции/Организации (JP -> RU) ===

グリフィン -> Гриффин и Крюгер | тип: PMC
I.O.P. -> I.O.P. | тип: корпорация
B.R.I.E.F. -> B.R.I.E.F. | тип: организация
新ソ連 -> Новый Советский Союз (URNC) | тип: государство
URNC -> URNC | тип: союз
非武装化管理委員会 -> Управление немилитарных сил | тип: агентство URNC
地下ブローカー -> Подпольные брокеры | тип: субъект рынка
ジラールグループ -> Группа Жирар | тип: концерн
鉄血工造 -> Сангвис Ферри | тип: корпорация (упраздн.)
マンギ -> Манги Секьюрити | тип: Организация
ヴァリャーグ -> Варягер | тип: Группировка

// === Глоссарий терминов (JP -> RU) ===

戦術人形 -> Тактическая кукла | категория: юнит
人形 -> Кукла | категория: юнит
崩壊結晶 -> Кристалл Коллапса | категория: ресурс
崩壊片 -> Осколки Коллапса | категория: валюта
コーラップス -> Коллапс | категория: явление
ELID -> ELID | категория: болезнь
ホワイトゾーン -> Белая зона | категория: территория
グリーンゾーン -> Зелёная зона | категория: территория
汚染区域 -> Зона загрязнения | категория: территория
エルモ -> Элмо | категория: оборудование
長城列車 -> Железная дорога Великой Стены | категория: инфраструктура
エリザ -> ИИ «Элиза» | категория: персона/ИИ
銃 -> оружие | категория: предмет
ポリ合金 -> полисплав | категория: материал
フロストフォール -> Фростфолл | категория: локация/событие
世代 -> поколение | категория: термин
第3世代 -> Кукла третьего поколения | категория: термин
素体 -> корпус (тело) | категория: термин
マインドマップ -> нейронное облако | "память", "мозг" куклы
指揮官 -> Командир (Игрок) | роль: игрок